Sumerian: ЁТБ▓ЁТИаЁТГ╢ЁТИиЁТВЧ
Ancient Greek: ╬Яс╝╡╧Д╬╣╬╜╬н╧В ╧А╬┐╧Дс╛┐ с╝Ф╧Г╧Д╬╡ ╧З╬▒╬п╧Б╬╡╧Д╬╡! ╬Хс╝░╧Б╬╖╬╜╬╣╬║с┐╢╧В ╧А╧Бс╜╕╧В ╧Ж╬п╬╗╬┐╧Е╧В с╝Р╬╗╬╖╬╗╧Н╬╕╬▒╬╝╬╡╬╜ ╧Ж╬п╬╗╬┐╬╣.
Portuguese: Paz e felicidade a todos
Cantonese: хРДф╜Нхе╜хЧОя╝ЯчеЭхРДф╜Нх╣│хоЙхБех║╖х┐лциВуАВ
Akkadian: Adanni┼б lu ┼бulmu
Russian: ╨Ч╨┤╤А╨░╨▓╤Б╤В╨▓╤Г╨╣╤В╨╡! ╨Я╤А╨╕╨▓╨╡╤В╤Б╤В╨▓╤Г╤О ╨Т╨░╤Б!
Thai: р╕кр╕зр╕▒р╕кр╕Фр╕╡р╕Др╣Ир╕░ р╕кр╕лр╕▓р╕вр╣Гр╕Щр╕Шр╕гр╕Ур╕╡р╣Вр╕Юр╣Йр╕Щ р╕Юр╕зр╕Бр╣Ар╕гр╕▓р╣Гр╕Щр╕Шр╕гр╕Ур╕╡р╕Щр╕╡р╣Йр╕Вр╕нр╕кр╣Ир╕Зр╕бр╕┤р╕Хр╕гр╕Ир╕┤р╕Хр╕бр╕▓р╕Цр╕╢р╕Зр╕Чр╣Ир╕▓р╕Щр╕Чр╕╕р╕Бр╕Др╕Щ
Arabic: ╪к╪н┘К╪з╪к┘Ж╪з ┘Д┘Д╪г╪╡╪п┘В╪з╪б ┘Б┘К ╪з┘Д┘Ж╪м┘И┘Е. ┘К╪з ┘Д┘К╪к ┘К╪м┘Е╪╣┘Ж╪з ╪з┘Д╪▓┘Е╪з┘Ж.
Romanian: Salut─Гri la toat─Г lumea
French: Bonjour tout le monde
Burmese: сАФсА▒сААсА▒сАмсАДсА║сА╕сАХсАлсАЮсАЬсАмсА╕
Hebrew: ╫й╫Ь╫Х╫Э
Spanish: Hola y saludos a todos
Indonesian: Selamat malam hadirin sekalian, selamat berpisah dan sampai bertemu lagi dilain waktu
Quechua: Kay pachamamta niytapas maytapas rimapallasta runasimipi
Punjabi: риЖриУ риЬрйА, риЬрйА риЖриЗриЖриВ риирйВрй░
Hittite: a┼б┼бuli
Bengali: ржиржорж╕рзНржХрж╛рж░, ржмрж┐рж╢рзНржмрзЗ рж╢рж╛ржирзНрждрж┐ рж╣рзЛржХ
Latin: Salvete quicumque estis; bonam erga vos voluntatem habemus, et pacem per astra ferimus
Aramaic: ЁРбМЁРбЛЁРбФ
Dutch: Hartelijke groeten aan iedereen
German: Herzliche Gr├╝├Яe an alle
Urdu: ╪з┘Д╪│┘Д╪з┘Е ╪╣┘Д┘К┌й┘Е ┘А █Б┘Е ╪▓┘Е┘К┘Ж ┌й█Т ╪▒█Б┘Ж█Т ┘И╪з┘Д┘И┌║ ┌й┘Й ╪╖╪▒┘Б ╪│█Т ╪в┘╛ ┌й┘И ╪о┘И╪┤ ╪в┘Е╪п┘К╪п ┌й█Б╪к█Т ┌╛┘К┌║
Vietnamese: Ch├вn th├аnh gс╗нi tс╗Ыi c├бc bс║бn lс╗Эi ch├аo th├вn hс╗пu
Turkish: Say─▒n T├╝rk├зe bilen arkada┼Яlar─▒m─▒z, sabah ┼Яerifleriniz hayrolsun
Japanese: уБУуВУуБлуБбуБпуАВуБКхЕГц░ЧуБзуБЩуБЛя╝Я
Hindi: рдзрд░рддреА рдХреЗ рд╡рд╛рд╕рд┐рдпреЛрдВ рдХреА рдУрд░ рд╕реЗ рдирдорд╕реНрдХрд╛рд░
Welsh: Iechyd da i chi yn awr, ac yn oesoedd
Italian: Tanti auguri e saluti
Sinhalese: р╢Жр╢║р╖Фр╢╢р╖Эр╖Ар╢▒р╖К!
Zulu: Siya nibingelela maqhawe sinifisela inkonzo ende.
Sotho: Reani lumelisa marela.
Wu: чеЭуСЪхдзхо╢хе╜уАВ
Armenian: ╘▓╒╕╒м╒╕╓А ╒б╒╢╒╕╒╢╓Б ╒╕╓А ╒п╒и ╒г╒┐╒╢╒╕╓В╒л╒╢ ╒┐╒л╒е╒ж╒е╓А╒г╒л ╒┤╒л╒г╒б╒┤╒б╒о╒╕╓В╒й╒л╓В╒╢╒з╒╢ ╒б╒╢╒д╒л╒╢, ╒╕╒▓╒╗╒╕╒╡╒╢╒╢╒е╓А
Korean: ьХИыЕХэХШьД╕ьЪФ
Polish: Witajcie, istoty z za┼Ыwiat├│w.
Nepali: рдкреНрд░рд┐рдереНрд╡реА рд╡рд╛рд╕реАрд╣рд░реБ рдмрд╛рдЯ рд╢рд╛рдиреНрддрд┐ рдордп рднрд╡рд┐рд╖реНрдп рдХреЛ рд╢реБрднрдХрд╛рдордирд╛
Mandarin Chinese: хРДф╜НщГ╜хе╜хРзя╝ЯцИСхАСщГ╜х╛ИцГ│х┐╡ф╜ахАСя╝МцЬЙчй║шлЛхИ░щАЩхЕТф╛ЖчОйуАВ
Ila: Mypone kaboutu noose.
Swedish: H├дlsningar fr├еn en dataprogrammerare i den lilla universitetsstaden Ithaca p├е planeten Jorden
Nyanja: Mulibwanji imwe boonse bantu bakumwamba.
Gujarati: рккрлГркерлНрк╡рлА ркЙрккрк░ рк╡рк╕ркирк╛рк░ ркПркХ ркорк╛ркирк╡ ркдрк░рклркерлА ркмрлНрк░рк╣рлНркорк╛ркВркбркирк╛ ркЕркирлНркп ркЕрк╡ркХрк╛рк╢ркорк╛ркВ рк╡рк╕ркирк╛рк░рк╛ркУркирлЗ рк╣рк╛рк░рлНркжрк┐ркХ ркЕркнрк┐ркиркВркжрки. ркЖ рк╕ркВркжрлЗрк╢рлЛ ркорк│рлНркпрлЗ, рк╡рк│ркдрлЛ рк╕ркВркжрлЗрк╢рлЛ ркорлЛркХрк▓рк╛рк╡рк╢рлЛ.
Ukrainian: ╨Я╨╡╤А╨╡╤Б╨╕╨╗╨░╤Ф╨╝╨╛ ╨┐╤А╨╕╨▓╤Ц╤В ╤Ц╨╖ ╨╜╨░╤И╨╛╨│╨╛ ╤Б╨▓╤Ц╤В╤Г, ╨▒╨░╨╢╨░╤Ф╨╝╨╛ ╤Й╨░╤Б╤В╤П, ╨╖╨┤╨╛╤А╨╛╨▓'╤П ╤Ц ╨╝╨╜╨╛╨│╨░╤П ╨╗╤Ц╤В╨░
Persian: ╪п╪▒┘И╪п ╪и╪▒ ╪│╪з┌й┘Ж╪з┘Ж ╪в╪│┘Е╪з┘Ж┘З╪з█М ╪п┘И╪▒
Serbian: ╨Ц╨╡╨╗╨╕╨╝╨╛ ╨▓╨░╨╝ ╤Б╨▓╨╡ ╨╜╨░╤Ш╨╗╨╡╨┐╤И╨╡ ╤Б╨░ ╨╜╨░╤И╨╡ ╨┐╨╗╨░╨╜╨╡╤В╨╡
Oriya: рм╕рнВрм░рнНрмпрнНрнЯ рмдрм╛рм░рмХрм╛рм░ рмдрнГрмдрнАрнЯ рмЧрнНрм░рм╣ рмкрнГрмерм┐рммрнАрм░рнБ рммрм┐рм╢рнНрн▒рммрнНрм░рм╣рнНрморм╛рмгрнНрмбрм░ рмЕрмзрм┐рммрм╛рм╕рнА рморм╛рмирмЩрнНрмХрнБ рмЕрмнрм┐рмирмирнНрмжрми
Luganda: Musulayo mutya abantu bensi eno mukama abawe emirembe bulijo.
Marathi: рдирдорд╕реНрдХрд╛рд░. рд╣реНрдпрд╛ рдкреГрдереНрд╡реАрддреАрд▓ рд▓реЛрдХ рддреБрдореНрд╣рд╛рд▓рд╛ рддреНрдпрд╛рдВрдЪреЗ рд╢реБрднрд╡рд┐рдЪрд╛рд░ рдкрд╛рдард╡рддрд╛рдд рдЖрдгрд┐ рддреНрдпрд╛рдВрдЪреА рдЗрдЪреНрдЫрд╛ рдЖрд╣реЗ рдХреА рддреБрдореНрд╣реА рд╣реНрдпрд╛ рдЬрдиреНрдореА рдзрдиреНрдп рд╡реНрд╣рд╛.
Amoy: хдкчй║цЬЛхПЛя╝МцББхе╜я╝БцББщгЯщг╜цЬкя╝ЯцЬЙщЦТшСЧф╛ЖщШощБохЭРхЦФуАВ
Hungarian: ├Ьdv├╢zletet k├╝ld├╝nk magyar nyelven minden b├йk├йt szeret┼С l├йnynek a Vil├бgegyetemen
Telugu: р░ир░ор░╕р▒Нр░др▒З, р░др▒Жр░▓р▒Бр░Чр▒Б р░ор░╛р░Яр▒Нр░▓р░╛р░бр▒З р░Ьр░ир░ор▒Бр░ир░ир░┐р░Вр░Ър░┐ р░ор░╛ р░╢р▒Бр░нр░╛р░Хр░╛р░Вр░Хр▒Нр░╖р░▓р▒Б.
Czech: Mil├н p┼Щ├бtel├й, p┼Щejeme v├бm v┼бe nejlep┼б├н
Kannada: р▓ир▓ор▓╕р│Нр▓др│Ж, р▓Хр▓ир│Нр▓ир▓бр▓┐р▓Чр▓░ р▓кр▓░р▓╡р▓╛р▓Чр▓┐ р▓╢р│Бр▓нр▓╛р▓╖р▓пр▓Чр▓│р│Б.
Rajasthani: рд╕рдм рднрд╛рдЗрдореЛ рдиреЗ рдореНрд╣рд╛рд░реЛ рд░рд╛рдо рдкрд╣реБреЕрдЪреЗ рд╣рдорд╛ рдЕрдВрдбреЗ рдЦреБрд╢реА рдбреЙ рдЙрдореНрд╣рд╛ рд╡рд╣рд╛рдБ рдЦреБрдЧреЛ рд░реАрдЧреЛ
English: Hello from the children of planet Earth
